
_,_,_,4,_
_,_,x,|,_
_,_,x,2,x
_,x,_,|,_
x,3,-,1,x
_,x,_,x,_